ROW= 8,LINE= 9
.,.,.,.,.,=,.,.,
.,.,.,.,.,=,=,=,
.,.,.,.,.,.,.,.,
.,.,.,.,.,.,.,.,
.,.,.,F,.,.,.,.,
.,.,.,.,.,.,.,.,
.,.,.,.,.,.,.,.,
.,.,.,.,.,.,+,+,
.,.,.,.,+,+,+,+,
